03123111111111111111
11111111111111111111
10001000000000001111
10101010111111151111
14101015000040000421
10141010111111101111
10100010111111151111
10101110111111101111
10101110111111101111
10101110111111101111
10000000000000001111
