00000111111111110000
00000500000001010000
00000100000001010000
00000100000001010000
00000100011111010000
00000100010001010000
00000111111111111112
00000100000001000101
00000115111111111111
00000000000000000000
